"player","season","team","position","salary","games","games_started","minutes","field_goals","field_goals_atts","field_goals_perc","points3","points3_atts","points3_perc","points2","points2_atts","points2_perc","effective_field_goal_perc","points1","points1_atts","points1_perc","off_rebounds","def_rebounds","total_rebounds","assists","steals","blocks","turnovers","fouls","points"
"Al Horford",2017,"BOS","C",26540100,68,68,2193,379,801,0.473,86,242,0.355,293,559,0.524,0.527,108,135,0.8,95,369,464,337,52,87,116,138,952
"Amir Johnson",2017,"BOS","PF",1.2e+07,80,77,1608,213,370,0.576,27,66,0.409,186,304,0.612,0.612,67,100,0.67,117,248,365,140,52,62,77,211,520
"Avery Bradley",2017,"BOS","SG",8269663,55,55,1835,359,775,0.463,108,277,0.39,251,498,0.504,0.533,68,93,0.731,65,269,334,121,68,11,88,141,894
"Demetrius Jackson",2017,"BOS","PG",1450000,5,0,17,3,4,0.75,1,1,1,2,3,0.667,0.875,3,6,0.5,2,2,4,3,0,0,0,0,10
"Gerald Green",2017,"BOS","SF",1410598,47,0,538,95,232,0.409,39,111,0.351,56,121,0.463,0.494,33,41,0.805,17,68,85,33,9,7,25,48,262
"Isaiah Thomas",2017,"BOS","PG",6587132,76,76,2569,682,1473,0.463,245,646,0.379,437,827,0.528,0.546,590,649,0.909,43,162,205,449,70,13,210,167,2199
"Jae Crowder",2017,"BOS","SF",6286408,72,72,2335,333,720,0.463,157,394,0.398,176,326,0.54,0.572,176,217,0.811,48,367,415,155,72,23,79,161,999
"James Young",2017,"BOS","SG",1825200,29,0,220,25,58,0.431,12,35,0.343,13,23,0.565,0.534,6,9,0.667,6,20,26,4,10,2,4,15,68
"Jaylen Brown",2017,"BOS","SF",4743000,78,20,1341,192,423,0.454,46,135,0.341,146,288,0.507,0.508,85,124,0.685,45,175,220,64,35,18,68,142,515
"Jonas Jerebko",2017,"BOS","PF",5e+06,78,6,1232,114,262,0.435,45,130,0.346,69,132,0.523,0.521,26,37,0.703,60,213,273,71,26,17,39,122,299
"Jordan Mickey",2017,"BOS","PF",1223653,25,1,141,15,34,0.441,0,1,0,15,33,0.455,0.441,8,14,0.571,13,21,34,7,3,6,9,12,38
"Kelly Olynyk",2017,"BOS","C",3094014,75,6,1538,260,508,0.512,68,192,0.354,192,316,0.608,0.579,90,123,0.732,72,288,360,148,43,29,96,207,678
"Marcus Smart",2017,"BOS","SG",3578880,79,24,2399,269,749,0.359,94,332,0.283,175,417,0.42,0.422,203,250,0.812,78,228,306,364,125,34,159,192,835
"Terry Rozier",2017,"BOS","PG",1906440,74,0,1263,151,411,0.367,57,179,0.318,94,232,0.405,0.437,51,66,0.773,40,187,227,131,45,11,47,69,410
"Tyler Zeller",2017,"BOS","C",8e+06,51,5,525,78,158,0.494,0,1,0,78,157,0.497,0.494,22,39,0.564,43,81,124,42,7,21,20,61,178
"Channing Frye",2017,"CLE","C",7806971,74,15,1398,238,520,0.458,137,335,0.409,101,185,0.546,0.589,63,74,0.851,37,253,290,45,33,37,53,138,676
"Dahntay Jones",2017,"CLE","SF",18255,1,0,12,3,8,0.375,0,2,0,3,6,0.5,0.375,3,4,0.75,1,1,2,1,0,0,1,1,9
"Deron Williams",2017,"CLE","PG",259626,24,4,486,68,147,0.463,22,53,0.415,46,94,0.489,0.537,21,25,0.84,1,44,45,86,6,6,40,42,179
"Derrick Williams",2017,"CLE","PF",268029,25,0,427,54,107,0.505,21,52,0.404,33,55,0.6,0.603,27,39,0.692,3,54,57,14,5,2,14,27,156
"Iman Shumpert",2017,"CLE","SG",9700000,76,31,1937,201,489,0.411,94,261,0.36,107,228,0.469,0.507,71,90,0.789,39,180,219,109,62,27,78,150,567
"J.R. Smith",2017,"CLE","SG",12800000,41,35,1187,123,356,0.346,95,271,0.351,28,85,0.329,0.479,10,15,0.667,17,96,113,62,40,11,26,77,351
"James Jones",2017,"CLE","SF",1551659,48,2,381,44,92,0.478,31,66,0.47,13,26,0.5,0.647,13,20,0.65,3,35,38,14,7,10,10,37,132
"Kay Felder",2017,"CLE","PG",543471,42,0,386,62,158,0.392,7,22,0.318,55,136,0.404,0.415,35,49,0.714,3,38,41,58,18,7,31,38,166
"Kevin Love",2017,"CLE","PF",21165675,60,60,1885,370,867,0.427,145,389,0.373,225,478,0.471,0.51,257,295,0.871,148,518,666,116,53,22,122,125,1142
"Kyle Korver",2017,"CLE","SG",5239437,35,1,859,131,269,0.487,97,200,0.485,34,69,0.493,0.667,14,15,0.933,7,90,97,35,11,8,29,60,373
"Kyrie Irving",2017,"CLE","PG",17638063,72,72,2525,671,1420,0.473,177,441,0.401,494,979,0.505,0.535,297,328,0.905,52,178,230,418,83,25,180,157,1816
"LeBron James",2017,"CLE","SF",30963450,74,74,2794,736,1344,0.548,124,342,0.363,612,1002,0.611,0.594,358,531,0.674,97,543,640,646,92,44,303,134,1954
"Richard Jefferson",2017,"CLE","SF",2500000,79,13,1614,153,343,0.446,62,186,0.333,91,157,0.58,0.536,80,108,0.741,28,174,202,78,26,10,52,153,448
"Tristan Thompson",2017,"CLE","C",15330435,78,78,2336,262,437,0.6,0,3,0,262,434,0.604,0.6,106,213,0.498,287,429,716,77,39,84,64,176,630
"Cory Joseph",2017,"TOR","SG",7330000,80,22,2003,299,661,0.452,48,135,0.356,251,526,0.477,0.489,94,122,0.77,52,184,236,265,66,13,109,140,740
"Delon Wright",2017,"TOR","PG",1577280,27,0,446,49,116,0.422,10,30,0.333,39,86,0.453,0.466,42,55,0.764,16,32,48,57,27,11,25,31,150
"DeMar DeRozan",2017,"TOR","SG",26540100,74,74,2620,721,1545,0.467,33,124,0.266,688,1421,0.484,0.477,545,647,0.842,70,316,386,290,78,13,180,134,2020
"DeMarre Carroll",2017,"TOR","SF",14200000,72,72,1882,220,549,0.401,109,320,0.341,111,229,0.485,0.5,89,117,0.761,63,212,275,74,81,27,54,143,638
"Fred VanVleet",2017,"TOR","PG",543471,37,0,294,39,111,0.351,11,29,0.379,28,82,0.341,0.401,18,22,0.818,4,38,42,35,17,2,15,36,107
"Jonas Valanciunas",2017,"TOR","C",14382022,80,80,2066,391,702,0.557,1,2,0.5,390,700,0.557,0.558,176,217,0.811,226,533,759,57,37,63,106,216,959
"Kyle Lowry",2017,"TOR","PG",1.2e+07,60,60,2244,426,918,0.464,193,468,0.412,233,450,0.518,0.569,299,365,0.819,48,239,287,417,88,19,173,170,1344
"Lucas Nogueira",2017,"TOR","C",1921320,57,6,1088,103,156,0.66,3,12,0.25,100,144,0.694,0.67,44,67,0.657,82,161,243,42,52,90,46,137,253
"Norman Powell",2017,"TOR","SG",874636,76,18,1368,227,506,0.449,56,173,0.324,171,333,0.514,0.504,126,159,0.792,26,142,168,82,51,14,70,127,636
"P.J. Tucker",2017,"TOR","SF",5300000,24,4,609,52,128,0.406,24,60,0.4,28,68,0.412,0.5,11,16,0.688,23,106,129,26,31,5,14,53,139
"Pascal Siakam",2017,"TOR","PF",1196040,55,38,859,103,205,0.502,1,7,0.143,102,198,0.515,0.505,22,32,0.688,64,122,186,17,26,45,33,109,229
"Patrick Patterson",2017,"TOR","PF",6050000,65,8,1599,154,384,0.401,94,253,0.372,60,131,0.458,0.523,43,60,0.717,62,229,291,76,40,23,38,120,445
"Serge Ibaka",2017,"TOR","PF",12250000,23,23,712,128,279,0.459,41,103,0.398,87,176,0.494,0.532,30,34,0.882,29,127,156,15,7,33,39,76,327
"Bojan Bogdanovic",2017,"WAS","SF",3730653,26,0,601,107,234,0.457,45,115,0.391,62,119,0.521,0.553,71,76,0.934,14,66,80,21,10,4,38,47,330
"Bradley Beal",2017,"WAS","SG",22116750,77,77,2684,637,1322,0.482,223,552,0.404,414,770,0.538,0.566,282,342,0.825,53,186,239,267,83,21,157,169,1779
"Brandon Jennings",2017,"WAS","PG",1200000,23,2,374,29,106,0.274,11,52,0.212,18,54,0.333,0.325,12,17,0.706,8,36,44,108,15,0,22,32,81
"Jason Smith",2017,"WAS","C",5e+06,74,3,1068,174,329,0.529,37,78,0.474,137,251,0.546,0.585,35,51,0.686,64,194,258,37,21,55,58,168,420
"John Wall",2017,"WAS","PG",16957900,78,78,2836,647,1435,0.451,89,272,0.327,558,1163,0.48,0.482,422,527,0.801,58,268,326,831,157,49,323,151,1805
"Marcin Gortat",2017,"WAS","C",1.2e+07,82,82,2556,390,674,0.579,0,2,0,390,672,0.58,0.579,103,159,0.648,238,611,849,121,40,65,118,213,883
"Markieff Morris",2017,"WAS","PF",7400000,76,76,2374,406,889,0.457,71,196,0.362,335,693,0.483,0.497,180,215,0.837,107,385,492,126,82,42,129,254,1063
"Otto Porter",2017,"WAS","SF",5893981,80,80,2605,414,803,0.516,148,341,0.434,266,462,0.576,0.608,99,119,0.832,118,397,515,121,116,41,43,193,1075
"Sheldon McClellan",2017,"WAS","SG",543471,30,3,287,30,75,0.4,7,30,0.233,23,45,0.511,0.447,23,27,0.852,4,30,34,15,8,2,5,17,90
"Tomas Satoransky",2017,"WAS","SG",2870813,57,3,719,61,146,0.418,9,37,0.243,52,109,0.477,0.449,23,33,0.697,25,58,83,92,26,6,38,60,154
"Trey Burke",2017,"WAS","PG",3386598,57,0,703,116,255,0.455,31,70,0.443,85,185,0.459,0.516,22,29,0.759,7,40,47,100,11,5,48,54,285
"DeAndre' Bembry",2017,"ATL","SF",1499760,38,1,371,47,98,0.48,1,18,0.056,46,80,0.575,0.485,6,16,0.375,14,45,59,28,8,5,16,21,101
"Dennis Schroder",2017,"ATL","PG",2708582,79,78,2485,548,1215,0.451,100,294,0.34,448,921,0.486,0.492,218,255,0.855,42,206,248,499,74,16,258,149,1414
"Dwight Howard",2017,"ATL","C",23180275,74,74,2199,388,613,0.633,0,2,0,388,611,0.635,0.633,226,424,0.533,296,644,940,104,64,92,170,203,1002
"Ersan Ilyasova",2017,"ATL","PF",8400000,26,12,633,93,226,0.412,32,92,0.348,61,134,0.455,0.482,52,65,0.8,42,109,151,43,22,8,34,73,270
"Jose Calderon",2017,"ATL","PG",392478,17,2,247,23,57,0.404,8,30,0.267,15,27,0.556,0.474,7,8,0.875,7,25,32,37,4,0,15,14,61
"Kent Bazemore",2017,"ATL","SF",15730338,73,64,1963,295,721,0.409,92,266,0.346,203,455,0.446,0.473,119,168,0.708,45,186,231,177,91,52,125,165,801
"Kris Humphries",2017,"ATL","PF",4e+06,56,4,689,87,214,0.407,19,54,0.352,68,160,0.425,0.451,64,82,0.78,60,146,206,29,15,21,28,69,257
"Malcolm Delaney",2017,"ATL","PG",2500000,73,2,1248,145,388,0.374,26,110,0.236,119,278,0.428,0.407,75,93,0.806,11,113,124,193,39,1,95,112,391
"Mike Dunleavy",2017,"ATL","SF",4837500,30,0,475,57,130,0.438,33,77,0.429,24,53,0.453,0.565,22,26,0.846,13,55,68,30,9,5,14,35,169
"Mike Muscala",2017,"ATL","C",1015696,70,3,1237,170,337,0.504,46,110,0.418,124,227,0.546,0.573,49,64,0.766,76,164,240,95,30,41,55,97,435
"Paul Millsap",2017,"ATL","PF",20072033,69,67,2343,430,972,0.442,75,241,0.311,355,731,0.486,0.481,311,405,0.768,111,422,533,252,90,62,158,186,1246
"Ryan Kelly",2017,"ATL","PF",418228,16,0,110,8,28,0.286,4,10,0.4,4,18,0.222,0.357,5,6,0.833,1,17,18,8,4,5,4,5,25
"Thabo Sefolosha",2017,"ATL","SF",3850000,62,42,1596,174,395,0.441,41,120,0.342,133,275,0.484,0.492,55,75,0.733,54,216,270,107,96,31,58,97,444
"Tim Hardaway",2017,"ATL","SG",2281605,79,30,2154,415,912,0.455,149,417,0.357,266,495,0.537,0.537,164,214,0.766,35,189,224,182,55,15,106,103,1143
"Giannis Antetokounmpo",2017,"MIL","SF",2995421,80,80,2845,656,1259,0.521,49,180,0.272,607,1079,0.563,0.541,471,612,0.77,142,558,700,434,131,151,234,246,1832
"Greg Monroe",2017,"MIL","C",17100000,81,0,1823,387,726,0.533,0,4,0,387,722,0.536,0.533,177,239,0.741,167,365,532,187,92,38,140,168,951
"Jabari Parker",2017,"MIL","PF",5374320,51,50,1728,399,814,0.49,65,178,0.365,334,636,0.525,0.53,162,218,0.743,79,235,314,142,51,22,92,111,1025
"Jason Terry",2017,"MIL","SG",1551659,74,0,1365,105,243,0.432,73,171,0.427,32,72,0.444,0.582,24,29,0.828,15,91,106,98,45,20,36,95,307
"John Henson",2017,"MIL","C",12517606,58,39,1123,159,309,0.515,0,1,0,159,308,0.516,0.515,74,107,0.692,92,203,295,57,29,78,53,151,392
"Khris Middleton",2017,"MIL","SF",15200000,29,23,889,150,333,0.45,45,104,0.433,105,229,0.459,0.518,81,92,0.88,11,112,123,99,41,7,65,79,426
"Malcolm Brogdon",2017,"MIL","SG",925000,75,28,1982,290,635,0.457,78,193,0.404,212,442,0.48,0.518,109,126,0.865,47,166,213,317,84,12,113,140,767
"Matthew Dellavedova",2017,"MIL","PG",9607500,76,54,1986,208,534,0.39,79,215,0.367,129,319,0.404,0.463,82,96,0.854,24,123,147,357,53,0,133,153,577
"Michael Beasley",2017,"MIL","PF",1403611,56,6,935,216,406,0.532,18,43,0.419,198,363,0.545,0.554,78,105,0.743,40,153,193,53,28,27,66,92,528
"Mirza Teletovic",2017,"MIL","PF",10500000,70,2,1133,156,418,0.373,104,305,0.341,52,113,0.46,0.498,35,45,0.778,11,151,162,48,12,13,37,109,451
"Rashad Vaughn",2017,"MIL","SG",1811040,41,2,458,57,156,0.365,26,81,0.321,31,75,0.413,0.449,2,5,0.4,4,45,49,23,19,10,14,32,142
"Spencer Hawes",2017,"MIL","PF",6348759,19,0,171,30,59,0.508,9,26,0.346,21,33,0.636,0.585,14,18,0.778,6,39,45,19,2,4,9,16,83
"Thon Maker",2017,"MIL","C",2568600,57,34,562,83,181,0.459,28,74,0.378,55,107,0.514,0.536,32,49,0.653,40,74,114,23,10,26,17,84,226
"Tony Snell",2017,"MIL","SG",2368327,80,80,2336,246,541,0.455,144,355,0.406,102,186,0.548,0.588,47,58,0.81,22,226,248,96,54,14,55,125,683
"Aaron Brooks",2017,"IND","PG",2700000,65,0,894,121,300,0.403,48,128,0.375,73,172,0.424,0.483,32,40,0.8,18,51,69,125,25,9,66,93,322
"Al Jefferson",2017,"IND","C",10230179,66,1,931,235,471,0.499,0,1,0,235,470,0.5,0.499,65,85,0.765,75,203,278,57,19,16,33,125,535
"C.J. Miles",2017,"IND","SF",4583450,76,29,1776,281,647,0.434,169,409,0.413,112,238,0.471,0.565,84,93,0.903,30,199,229,48,46,25,40,151,815
"Georges Niang",2017,"IND","PF",650000,23,0,93,9,36,0.25,1,12,0.083,8,24,0.333,0.264,2,2,1,2,15,17,5,3,0,5,6,21
"Jeff Teague",2017,"IND","PG",8800000,82,82,2657,402,909,0.442,90,252,0.357,312,657,0.475,0.492,360,415,0.867,33,298,331,639,100,32,216,165,1254
"Joe Young",2017,"IND","PG",1052342,33,0,135,26,72,0.361,5,23,0.217,21,49,0.429,0.396,11,15,0.733,1,16,17,15,4,0,5,5,68
"Kevin Seraphin",2017,"IND","PF",1800000,49,3,559,109,198,0.551,0,2,0,109,196,0.556,0.551,14,22,0.636,41,101,142,23,7,20,29,66,232
"Lance Stephenson",2017,"IND","SG",4e+06,6,0,132,18,44,0.409,5,8,0.625,13,36,0.361,0.466,2,3,0.667,1,23,24,25,3,2,11,12,43
"Lavoy Allen",2017,"IND","PF",4e+06,61,5,871,77,168,0.458,0,1,0,77,167,0.461,0.458,23,33,0.697,105,115,220,57,18,24,29,78,177
"Monta Ellis",2017,"IND","SG",10770000,74,33,1998,247,557,0.443,43,135,0.319,204,422,0.483,0.482,93,128,0.727,19,185,204,236,79,27,135,149,630
"Myles Turner",2017,"IND","C",2463840,81,81,2541,444,869,0.511,40,115,0.348,404,754,0.536,0.534,245,303,0.809,139,448,587,106,74,173,105,262,1173
"Paul George",2017,"IND","SF",18314532,75,75,2689,622,1349,0.461,195,496,0.393,427,853,0.501,0.533,336,374,0.898,58,434,492,251,117,27,218,206,1775
"Thaddeus Young",2017,"IND","PF",14153652,74,74,2237,362,687,0.527,45,118,0.381,317,569,0.557,0.56,45,86,0.523,131,318,449,122,114,30,96,135,814
"Anthony Morrow",2017,"CHI","SG",3488000,9,0,87,12,29,0.414,6,14,0.429,6,15,0.4,0.517,11,11,1,1,1,2,6,2,0,0,4,41
"Bobby Portis",2017,"CHI","PF",1453680,64,13,1000,183,375,0.488,32,96,0.333,151,279,0.541,0.531,39,59,0.661,75,220,295,35,16,11,37,94,437
"Cameron Payne",2017,"CHI","PG",2112480,11,0,142,21,63,0.333,11,34,0.324,10,29,0.345,0.421,1,4,0.25,1,16,17,15,4,0,13,14,54
"Denzel Valentine",2017,"CHI","SG",2092200,57,0,976,102,288,0.354,73,208,0.351,29,80,0.363,0.481,14,18,0.778,11,140,151,63,30,7,49,86,291
"Dwyane Wade",2017,"CHI","SG",23200000,60,59,1792,414,955,0.434,45,145,0.31,369,810,0.456,0.457,223,281,0.794,64,207,271,229,86,41,138,112,1096
"Isaiah Canaan",2017,"CHI","SG",1015696,39,0,592,63,173,0.364,25,94,0.266,38,79,0.481,0.436,30,33,0.909,6,43,49,37,22,1,20,35,181
"Jerian Grant",2017,"CHI","PG",1643040,63,28,1028,128,301,0.425,49,134,0.366,79,167,0.473,0.507,65,73,0.89,17,94,111,120,47,8,44,93,370
"Jimmy Butler",2017,"CHI","SF",17552209,76,75,2809,570,1252,0.455,91,248,0.367,479,1004,0.477,0.492,585,676,0.865,128,342,470,417,143,32,159,112,1816
"Joffrey Lauvergne",2017,"CHI","C",1709720,20,1,241,37,92,0.402,6,20,0.3,31,72,0.431,0.435,9,15,0.6,21,47,68,19,7,0,16,12,89
"Michael Carter-Williams",2017,"CHI","PG",3183526,45,19,846,112,306,0.366,15,64,0.234,97,242,0.401,0.391,58,77,0.753,24,128,152,113,38,23,66,102,297
"Nikola Mirotic",2017,"CHI","PF",5782450,70,15,1679,258,625,0.413,129,377,0.342,129,248,0.52,0.516,99,128,0.773,61,323,384,75,53,56,79,128,744
"Paul Zipser",2017,"CHI","SF",750000,44,18,843,88,221,0.398,33,99,0.333,55,122,0.451,0.473,31,40,0.775,15,110,125,36,15,16,40,78,240
"Rajon Rondo",2017,"CHI","PG",1.4e+07,69,42,1843,229,561,0.408,50,133,0.376,179,428,0.418,0.453,30,50,0.6,73,282,355,461,99,11,168,144,538
"Robin Lopez",2017,"CHI","C",13219250,81,81,2271,382,775,0.493,0,2,0,382,773,0.494,0.493,75,104,0.721,244,276,520,80,18,117,90,151,839
"Dion Waiters",2017,"MIA","SG",2898000,46,43,1384,281,663,0.424,85,215,0.395,196,448,0.438,0.488,82,127,0.646,18,136,154,200,41,20,103,95,729
"Goran Dragic",2017,"MIA","PG",15890000,73,73,2459,534,1124,0.475,117,289,0.405,417,835,0.499,0.527,298,377,0.79,61,217,278,423,89,13,212,199,1483
"James Johnson",2017,"MIA","PF",4e+06,76,5,2085,368,769,0.479,87,256,0.34,281,513,0.548,0.535,152,215,0.707,66,309,375,276,76,86,171,197,975
"Josh McRoberts",2017,"MIA","PF",5782450,22,14,381,44,118,0.373,13,31,0.419,31,87,0.356,0.428,6,9,0.667,23,51,74,50,10,4,23,31,107
"Josh Richardson",2017,"MIA","SG",874636,53,34,1614,202,513,0.394,75,227,0.33,127,286,0.444,0.467,60,77,0.779,35,133,168,140,60,39,65,132,539
"Justise Winslow",2017,"MIA","SF",2593440,18,15,625,80,225,0.356,7,35,0.2,73,190,0.384,0.371,29,47,0.617,23,71,94,66,27,6,33,52,196
"Luke Babbitt",2017,"MIA","SF",1227000,68,55,1065,113,281,0.402,87,210,0.414,26,71,0.366,0.557,11,15,0.733,13,129,142,36,21,11,25,118,324
"Okaro White",2017,"MIA","PF",210995,35,0,471,33,87,0.379,12,34,0.353,21,53,0.396,0.448,20,22,0.909,25,57,82,21,10,10,18,52,98
"Rodney McGruder",2017,"MIA","SG",543471,78,65,1966,190,460,0.413,73,220,0.332,117,240,0.488,0.492,44,71,0.62,95,162,257,124,45,18,56,140,497
"Tyler Johnson",2017,"MIA","PG",5628000,73,0,2178,357,824,0.433,93,250,0.372,264,574,0.46,0.49,195,254,0.768,50,243,293,233,84,44,90,176,1002
"Udonis Haslem",2017,"MIA","C",4e+06,17,0,130,11,23,0.478,0,3,0,11,20,0.55,0.478,9,15,0.6,8,28,36,6,5,1,8,22,31
"Wayne Ellington",2017,"MIA","SG",6e+06,62,13,1500,231,555,0.416,149,394,0.378,82,161,0.509,0.55,37,43,0.86,18,115,133,70,35,4,30,70,648
"Willie Reed",2017,"MIA","C",1015696,71,5,1031,162,285,0.568,1,4,0.25,161,281,0.573,0.57,49,88,0.557,129,203,332,26,18,47,31,137,374
"Andre Drummond",2017,"DET","C",22116750,81,81,2409,483,911,0.53,2,7,0.286,481,904,0.532,0.531,137,355,0.386,345,771,1116,89,124,89,152,237,1105
"Beno Udrih",2017,"DET","PG",1551659,39,0,560,92,197,0.467,11,32,0.344,81,165,0.491,0.495,32,34,0.941,6,51,57,131,13,0,37,29,227
"Darrun Hilliard",2017,"DET","SG",874060,39,1,381,47,126,0.373,12,46,0.261,35,80,0.438,0.421,21,28,0.75,2,31,33,33,11,2,28,39,127
"Henry Ellenson",2017,"DET","PF",1704120,19,2,146,23,64,0.359,10,35,0.286,13,29,0.448,0.438,4,8,0.5,8,33,41,7,1,1,14,6,60
"Ish Smith",2017,"DET","PG",6e+06,81,32,1955,329,749,0.439,28,105,0.267,301,644,0.467,0.458,72,102,0.706,21,214,235,418,61,33,112,127,758
"Jon Leuer",2017,"DET","PF",10991957,75,34,1944,310,646,0.48,49,167,0.293,261,479,0.545,0.518,98,113,0.867,102,300,402,111,31,26,66,145,767
"Kentavious Caldwell-Pope",2017,"DET","SG",3678319,76,75,2529,370,928,0.399,153,437,0.35,217,491,0.442,0.481,154,185,0.832,55,193,248,193,89,12,86,118,1047
"Marcus Morris",2017,"DET","SF",4625000,79,79,2565,421,1007,0.418,118,357,0.331,303,650,0.466,0.477,145,185,0.784,77,289,366,160,52,25,87,168,1105
"Michael Gbinije",2017,"DET","SG",650000,9,0,32,1,10,0.1,0,4,0,1,6,0.167,0.1,2,2,1,2,1,3,2,0,0,0,2,4
"Reggie Bullock",2017,"DET","SF",2255644,31,5,467,54,128,0.422,28,73,0.384,26,55,0.473,0.531,5,7,0.714,13,51,64,29,18,3,10,22,141
"Reggie Jackson",2017,"DET","PG",14956522,52,50,1424,284,677,0.419,66,184,0.359,218,493,0.442,0.468,118,136,0.868,21,92,113,270,35,5,114,129,752
"Stanley Johnson",2017,"DET","SF",2969880,77,1,1371,129,365,0.353,45,154,0.292,84,211,0.398,0.415,36,53,0.679,36,153,189,105,56,24,71,121,339
"Tobias Harris",2017,"DET","PF",17200000,82,48,2567,511,1063,0.481,109,314,0.347,402,749,0.537,0.532,190,226,0.841,63,353,416,142,60,39,95,133,1321
"Brian Roberts",2017,"CHO","PG",1050961,41,2,416,46,122,0.377,17,44,0.386,29,78,0.372,0.447,33,39,0.846,5,34,39,52,9,1,26,18,142
"Briante Weber",2017,"CHO","PG",102898,13,0,159,20,46,0.435,1,7,0.143,19,39,0.487,0.446,9,13,0.692,8,14,22,16,9,0,5,12,50
"Christian Wood",2017,"CHO","PF",874636,13,0,107,12,23,0.522,0,5,0,12,18,0.667,0.522,11,15,0.733,14,15,29,2,3,6,7,11,35
"Cody Zeller",2017,"CHO","PF",5318313,62,58,1725,253,443,0.571,0,1,0,253,442,0.572,0.571,133,196,0.679,135,270,405,99,62,58,65,189,639
"Frank Kaminsky",2017,"CHO","C",2730000,75,16,1954,320,802,0.399,116,354,0.328,204,448,0.455,0.471,118,156,0.756,57,279,336,162,47,34,76,139,874
"Jeremy Lamb",2017,"CHO","SG",6511628,62,5,1143,226,491,0.46,41,146,0.281,185,345,0.536,0.502,110,129,0.853,30,234,264,75,27,23,40,98,603
"Johnny O'Bryant",2017,"CHO","PF",161483,4,0,34,8,15,0.533,1,3,0.333,7,12,0.583,0.567,1,2,0.5,4,4,8,4,0,0,3,6,18
"Kemba Walker",2017,"CHO","PG",1.2e+07,79,79,2739,643,1449,0.444,240,602,0.399,403,847,0.476,0.527,304,359,0.847,45,263,308,435,85,22,168,119,1830
"Marco Belinelli",2017,"CHO","SG",6333333,74,0,1778,264,615,0.429,102,283,0.36,162,332,0.488,0.512,150,168,0.893,14,164,178,147,44,9,70,90,780
"Marvin Williams",2017,"CHO","PF",12250000,76,76,2295,297,704,0.422,124,354,0.35,173,350,0.494,0.51,131,150,0.873,89,409,498,106,58,53,60,134,849
"Michael Kidd-Gilchrist",2017,"CHO","SF",1.3e+07,81,81,2349,295,618,0.477,1,9,0.111,294,609,0.483,0.478,152,194,0.784,156,409,565,114,81,77,56,187,743
"Nicolas Batum",2017,"CHO","SG",20869566,77,77,2617,393,975,0.403,135,405,0.333,258,570,0.453,0.472,243,284,0.856,46,435,481,455,86,29,194,109,1164
"Ramon Sessions",2017,"CHO","PG",6e+06,50,1,811,100,263,0.38,21,62,0.339,79,201,0.393,0.42,91,118,0.771,11,62,73,129,26,3,46,43,312
"Treveon Graham",2017,"CHO","SG",543471,27,1,189,19,40,0.475,9,15,0.6,10,25,0.4,0.588,10,15,0.667,5,17,22,6,6,1,3,18,57
"Carmelo Anthony",2017,"NYK","SF",24559380,74,74,2538,602,1389,0.433,151,421,0.359,451,968,0.466,0.488,304,365,0.833,62,374,436,213,60,34,153,198,1659
"Chasson Randle",2017,"NYK","PG",143860,18,0,225,28,72,0.389,10,32,0.313,18,40,0.45,0.458,29,31,0.935,6,21,27,28,6,1,16,28,95
"Courtney Lee",2017,"NYK","SG",11242000,77,74,2459,321,704,0.456,108,269,0.401,213,435,0.49,0.533,85,98,0.867,53,207,260,179,81,23,69,141,835
"Derrick Rose",2017,"NYK","PG",21323250,64,64,2082,460,977,0.471,13,60,0.217,447,917,0.487,0.477,221,253,0.874,66,180,246,283,44,17,147,84,1154
"Joakim Noah",2017,"NYK","C",1.7e+07,46,46,1015,99,201,0.493,0,1,0,99,200,0.495,0.493,34,78,0.436,161,241,402,103,30,37,58,127,232
"Justin Holiday",2017,"NYK","SG",1015696,82,4,1639,233,538,0.433,97,273,0.355,136,265,0.513,0.523,66,80,0.825,27,198,225,102,65,31,66,109,629
"Kristaps Porzingis",2017,"NYK","PF",4317720,66,65,2164,443,985,0.45,112,314,0.357,331,671,0.493,0.507,198,252,0.786,111,364,475,97,47,130,118,244,1196
"Kyle O'Quinn",2017,"NYK","C",3900000,79,8,1229,215,413,0.521,2,17,0.118,213,396,0.538,0.523,64,83,0.771,157,282,439,117,36,104,76,174,496
"Lance Thomas",2017,"NYK","PF",6191000,46,15,968,97,244,0.398,38,85,0.447,59,159,0.371,0.475,43,51,0.843,32,110,142,35,21,5,25,85,275
"Maurice Ndour",2017,"NYK","PF",543471,32,4,331,39,86,0.453,1,7,0.143,38,79,0.481,0.459,19,26,0.731,22,42,64,8,15,8,12,30,98
"Mindaugas Kuzminskas",2017,"NYK","SF",2898000,68,5,1016,158,369,0.428,54,168,0.321,104,201,0.517,0.501,55,68,0.809,47,79,126,69,29,11,51,79,425
"Ron Baker",2017,"NYK","SG",543471,52,13,857,82,217,0.378,23,86,0.267,59,131,0.45,0.431,28,43,0.651,12,86,98,107,34,8,56,74,215
"Sasha Vujacic",2017,"NYK","SG",1410598,42,4,408,42,136,0.309,23,74,0.311,19,62,0.306,0.393,17,24,0.708,12,47,59,52,13,2,16,38,124
"Willy Hernangomez",2017,"NYK","C",1375000,72,22,1324,246,465,0.529,4,15,0.267,242,450,0.538,0.533,91,125,0.728,170,332,502,96,41,36,100,150,587
"Aaron Gordon",2017,"ORL","SF",4351320,80,72,2298,393,865,0.454,77,267,0.288,316,598,0.528,0.499,156,217,0.719,116,289,405,150,64,40,89,172,1019
"C.J. Watson",2017,"ORL","PG",5e+06,62,9,1012,96,248,0.387,32,105,0.305,64,143,0.448,0.452,57,66,0.864,16,73,89,114,43,2,47,84,281
"D.J. Augustin",2017,"ORL","PG",7250000,78,20,1538,195,517,0.377,95,274,0.347,100,243,0.412,0.469,131,161,0.814,15,102,117,209,31,1,90,101,616
"Elfrid Payton",2017,"ORL","PG",2613600,82,58,2412,430,912,0.471,40,146,0.274,390,766,0.509,0.493,146,211,0.692,89,298,387,529,88,40,178,177,1046
"Evan Fournier",2017,"ORL","SG",1.7e+07,68,66,2234,408,930,0.439,128,360,0.356,280,570,0.491,0.508,223,277,0.805,44,165,209,202,66,4,141,180,1167
"Jeff Green",2017,"ORL","PF",1.5e+07,69,11,1534,220,558,0.394,53,193,0.275,167,365,0.458,0.442,145,168,0.863,39,175,214,81,37,13,75,103,638
"Jodie Meeks",2017,"ORL","SG",6540000,36,10,738,103,256,0.402,56,137,0.409,47,119,0.395,0.512,65,74,0.878,5,72,77,45,34,4,36,41,327
"Marcus Georges-Hunt",2017,"ORL","SG",31969,5,0,48,2,7,0.286,1,2,0.5,1,5,0.2,0.357,9,10,0.9,1,8,9,3,1,0,2,5,14
"Mario Hezonja",2017,"ORL","SF",3909840,65,2,960,117,330,0.355,43,144,0.299,74,186,0.398,0.42,40,50,0.8,20,126,146,62,30,14,58,74,317
"Nikola Vucevic",2017,"ORL","C",11750000,75,55,2163,483,1031,0.468,23,75,0.307,460,956,0.481,0.48,107,160,0.669,176,603,779,208,77,74,117,180,1096
"Terrence Ross",2017,"ORL","SF",1e+07,24,24,748,115,267,0.431,46,135,0.341,69,132,0.523,0.517,23,27,0.852,4,64,68,43,34,13,35,61,299
"Alex Poythress",2017,"PHI","PF",31969,6,1,157,25,54,0.463,6,19,0.316,19,35,0.543,0.519,8,10,0.8,11,18,29,5,3,2,3,14,64
"Dario Saric",2017,"PHI","PF",2318280,81,36,2129,381,927,0.411,106,341,0.311,275,586,0.469,0.468,172,220,0.782,112,402,514,182,57,30,183,162,1040
"Gerald Henderson",2017,"PHI","SG",9e+06,72,41,1667,234,553,0.423,61,173,0.353,173,380,0.455,0.478,133,165,0.806,34,151,185,112,41,15,62,129,662
"Jerryd Bayless",2017,"PHI","PG",9424084,3,1,71,11,32,0.344,2,5,0.4,9,27,0.333,0.375,9,10,0.9,3,9,12,13,0,0,9,4,33
"Joel Embiid",2017,"PHI","C",4826160,31,31,786,200,429,0.466,36,98,0.367,164,331,0.495,0.508,191,244,0.783,61,182,243,66,27,76,117,112,627
"Justin Anderson",2017,"PHI","SF",1514160,24,8,518,75,162,0.463,21,72,0.292,54,90,0.6,0.528,32,41,0.78,30,66,96,34,13,7,26,45,203
"Nik Stauskas",2017,"PHI","SG",2993040,80,27,2188,251,634,0.396,132,359,0.368,119,275,0.433,0.5,122,150,0.813,21,205,226,188,46,32,128,144,756
"Richaun Holmes",2017,"PHI","C",1025831,57,17,1193,230,412,0.558,27,77,0.351,203,335,0.606,0.591,72,103,0.699,94,217,311,58,42,55,55,136,559
"Robert Covington",2017,"PHI","SF",1015696,67,67,2119,292,732,0.399,137,412,0.333,155,320,0.484,0.492,143,174,0.822,92,344,436,102,127,69,131,203,864
"Sergio Rodriguez",2017,"PHI","PG",8e+06,68,30,1518,210,536,0.392,92,252,0.365,118,284,0.415,0.478,18,27,0.667,21,136,157,344,48,4,128,95,530
"Shawn Long",2017,"PHI","C",89513,18,0,234,61,109,0.56,7,19,0.368,54,90,0.6,0.592,19,35,0.543,41,44,85,13,9,9,13,49,148
"T.J. McConnell",2017,"PHI","PG",874636,81,51,2133,236,512,0.461,11,55,0.2,225,457,0.492,0.472,73,90,0.811,39,212,251,534,133,10,159,139,556
"Tiago Splitter",2017,"PHI","C",8550000,8,0,76,14,31,0.452,2,6,0.333,12,25,0.48,0.484,9,11,0.818,8,14,22,4,1,1,6,8,39
"Timothe Luwawu-Cabarrot",2017,"PHI","SF",1326960,69,19,1190,145,361,0.402,50,161,0.311,95,200,0.475,0.471,105,123,0.854,25,123,148,75,32,10,73,154,445
"Andrew Nicholson",2017,"BRK","PF",6088993,10,0,111,13,34,0.382,2,11,0.182,11,23,0.478,0.412,2,2,1,4,23,27,3,5,0,6,18,30
"Archie Goodwin",2017,"BRK","SG",119494,12,0,184,34,61,0.557,4,13,0.308,30,48,0.625,0.59,23,32,0.719,7,21,28,23,4,4,14,7,95
"Brook Lopez",2017,"BRK","C",21165675,75,75,2222,555,1172,0.474,134,387,0.346,421,785,0.536,0.531,295,364,0.81,121,282,403,176,38,124,184,192,1539
"Caris LeVert",2017,"BRK","SF",1562280,57,26,1237,171,380,0.45,59,184,0.321,112,196,0.571,0.528,67,93,0.72,23,165,188,110,49,8,59,91,468
"Isaiah Whitehead",2017,"BRK","PG",1074145,73,26,1643,204,508,0.402,44,149,0.295,160,359,0.446,0.445,91,113,0.805,32,152,184,192,42,36,142,175,543
"Jeremy Lin",2017,"BRK","PG",11483254,36,33,883,175,400,0.438,58,156,0.372,117,244,0.48,0.51,115,141,0.816,11,124,135,184,41,14,86,79,523
"Joe Harris",2017,"BRK","SG",980431,52,11,1138,154,362,0.425,85,221,0.385,69,141,0.489,0.543,35,49,0.714,16,131,147,54,30,8,55,121,428
"Justin Hamilton",2017,"BRK","C",3e+06,64,7,1177,174,379,0.459,55,181,0.304,119,198,0.601,0.532,39,52,0.75,71,191,262,55,29,43,43,91,442
"K.J. McDaniels",2017,"BRK","SF",3333333,20,0,293,46,101,0.455,11,39,0.282,35,62,0.565,0.51,23,28,0.821,9,43,52,9,12,10,19,25,126
"Quincy Acy",2017,"BRK","PF",1790902,32,1,510,65,153,0.425,36,83,0.434,29,70,0.414,0.542,43,57,0.754,18,89,107,18,14,15,19,58,209
"Randy Foye",2017,"BRK","SG",2500000,69,40,1284,118,325,0.363,67,203,0.33,51,122,0.418,0.466,54,63,0.857,9,146,155,135,35,9,80,99,357
"Rondae Hollis-Jefferson",2017,"BRK","SF",1395600,78,50,1761,235,542,0.434,15,67,0.224,220,475,0.463,0.447,190,253,0.751,96,356,452,154,82,44,116,177,675
"Sean Kilpatrick",2017,"BRK","SG",980431,70,24,1754,305,735,0.415,105,308,0.341,200,427,0.468,0.486,204,242,0.843,22,258,280,157,46,6,136,118,919
"Spencer Dinwiddie",2017,"BRK","PG",726672,59,18,1334,134,302,0.444,38,101,0.376,96,201,0.478,0.507,126,159,0.792,27,137,164,185,44,23,66,119,432
"Trevor Booker",2017,"BRK","PF",9250000,71,43,1754,305,591,0.516,25,78,0.321,280,513,0.546,0.537,74,110,0.673,142,428,570,138,76,28,127,152,709
"Andre Iguodala",2017,"GSW","SF",11131368,76,0,1998,219,415,0.528,64,177,0.362,155,238,0.651,0.605,72,102,0.706,51,253,304,262,76,39,58,97,574
"David West",2017,"GSW","C",1551659,68,0,854,135,252,0.536,3,8,0.375,132,244,0.541,0.542,43,56,0.768,47,156,203,151,42,48,78,105,316
"Draymond Green",2017,"GSW","PF",15330435,76,76,2471,272,650,0.418,81,263,0.308,191,387,0.494,0.481,151,213,0.709,98,501,599,533,154,106,184,217,776
"Ian Clark",2017,"GSW","SG",1015696,77,0,1137,211,433,0.487,61,163,0.374,150,270,0.556,0.558,44,58,0.759,22,100,122,90,39,8,55,77,527
"James Michael McAdoo",2017,"GSW","PF",980431,52,2,457,62,117,0.53,2,8,0.25,60,109,0.55,0.538,21,42,0.5,34,56,90,17,18,29,19,47,147
"JaVale McGee",2017,"GSW","C",1403611,77,10,739,208,319,0.652,0,4,0,208,315,0.66,0.652,56,111,0.505,100,144,244,17,19,67,40,109,472
"Kevin Durant",2017,"GSW","SF",26540100,62,62,2070,551,1026,0.537,117,312,0.375,434,714,0.608,0.594,336,384,0.875,39,474,513,300,66,99,138,117,1555
"Kevon Looney",2017,"GSW","C",1182840,53,4,447,56,107,0.523,2,9,0.222,54,98,0.551,0.533,21,34,0.618,44,80,124,29,14,17,17,64,135
"Klay Thompson",2017,"GSW","SG",16663575,78,78,2649,644,1376,0.468,268,647,0.414,376,729,0.516,0.565,186,218,0.853,49,236,285,160,66,40,128,139,1742
"Matt Barnes",2017,"GSW","SF",383351,20,5,410,38,90,0.422,18,52,0.346,20,38,0.526,0.522,20,23,0.87,15,76,91,45,12,9,24,47,114
"Patrick McCaw",2017,"GSW","SG",543471,71,20,1074,106,245,0.433,41,123,0.333,65,122,0.533,0.516,29,37,0.784,22,79,101,77,32,15,36,62,282
"Shaun Livingston",2017,"GSW","PG",5782450,76,3,1345,173,316,0.547,1,3,0.333,172,313,0.55,0.549,42,60,0.7,28,123,151,139,38,20,61,120,389
"Stephen Curry",2017,"GSW","PG",12112359,79,79,2638,675,1443,0.468,324,789,0.411,351,654,0.537,0.58,325,362,0.898,61,292,353,523,143,17,239,183,1999
"Zaza Pachulia",2017,"GSW","C",2898000,70,70,1268,164,307,0.534,0,2,0,164,305,0.538,0.534,98,126,0.778,140,270,410,132,59,33,88,166,426
"Bryn Forbes",2017,"SAS","SG",543471,36,0,285,36,99,0.364,17,53,0.321,19,46,0.413,0.449,5,6,0.833,2,21,23,23,1,0,11,20,94
"Danny Green",2017,"SAS","SG",1e+07,68,68,1807,176,449,0.392,118,311,0.379,58,138,0.42,0.523,27,32,0.844,31,193,224,124,71,58,76,120,497
"Davis Bertans",2017,"SAS","PF",543471,67,6,808,103,234,0.44,69,173,0.399,34,61,0.557,0.588,28,34,0.824,22,77,99,46,20,28,32,75,303
"Dejounte Murray",2017,"SAS","PG",1180080,38,8,322,50,116,0.431,9,23,0.391,41,93,0.441,0.47,21,30,0.7,6,36,42,48,8,6,38,29,130
"Jonathon Simmons",2017,"SAS","SG",874636,78,8,1392,177,421,0.42,30,102,0.294,147,319,0.461,0.456,99,132,0.75,20,140,160,126,47,25,76,146,483
"Kawhi Leonard",2017,"SAS","SF",17638063,74,74,2474,636,1311,0.485,147,386,0.381,489,925,0.529,0.541,469,533,0.88,80,350,430,260,132,55,154,122,1888
"Kyle Anderson",2017,"SAS","SG",1192080,72,14,1020,93,209,0.445,15,40,0.375,78,169,0.462,0.481,45,57,0.789,33,175,208,91,51,26,39,63,246
"LaMarcus Aldridge",2017,"SAS","PF",20575005,72,72,2335,500,1049,0.477,23,56,0.411,477,993,0.48,0.488,220,271,0.812,174,350,524,139,46,89,98,158,1243
"Manu Ginobili",2017,"SAS","SG",1.4e+07,69,0,1291,171,439,0.39,89,227,0.392,82,212,0.387,0.491,86,107,0.804,28,129,157,183,82,16,96,119,517
"Patty Mills",2017,"SAS","PG",3578948,80,8,1754,273,622,0.439,147,356,0.413,126,266,0.474,0.557,66,80,0.825,24,118,142,280,65,3,101,109,759
"Pau Gasol",2017,"SAS","C",15500000,64,39,1627,303,604,0.502,56,104,0.538,247,500,0.494,0.548,130,184,0.707,107,394,501,150,24,70,81,110,792
"Tony Parker",2017,"SAS","PG",14445313,63,63,1587,265,569,0.466,23,69,0.333,242,500,0.484,0.486,85,117,0.726,9,104,113,285,33,2,89,92,638
"Bobby Brown",2017,"HOU","PG",680534,25,0,123,23,60,0.383,14,35,0.4,9,25,0.36,0.5,2,2,1,0,6,6,14,1,0,5,5,62
"Eric Gordon",2017,"HOU","SG",12385364,75,15,2323,412,1016,0.406,246,661,0.372,166,355,0.468,0.527,147,175,0.84,29,172,201,188,48,40,121,150,1217
"Isaiah Taylor",2017,"HOU","PG",255000,4,0,52,1,7,0.143,0,2,0,1,5,0.2,0.143,1,2,0.5,1,2,3,3,1,1,0,6,3
"James Harden",2017,"HOU","PG",26540100,81,81,2947,674,1533,0.44,262,756,0.347,412,777,0.53,0.525,746,881,0.847,95,564,659,906,120,37,464,215,2356
"Kyle Wiltjer",2017,"HOU","PF",543471,14,0,44,4,14,0.286,4,13,0.308,0,1,0,0.429,1,2,0.5,4,6,10,2,3,1,5,4,13
"Lou Williams",2017,"HOU","SG",7e+06,23,0,591,102,264,0.386,41,129,0.318,61,135,0.452,0.464,98,113,0.867,12,58,70,56,15,9,40,25,343
"Montrezl Harrell",2017,"HOU","C",1e+06,58,14,1064,225,345,0.652,1,7,0.143,224,338,0.663,0.654,76,121,0.628,81,138,219,64,20,42,44,126,527
"Patrick Beverley",2017,"HOU","SG",6e+06,67,67,2058,228,543,0.42,110,288,0.382,118,255,0.463,0.521,73,95,0.768,95,299,394,281,99,25,100,222,639
"Ryan Anderson",2017,"HOU","PF",18735364,72,72,2116,323,773,0.418,204,506,0.403,119,267,0.446,0.55,129,150,0.86,112,218,330,68,32,14,55,142,979
"Sam Dekker",2017,"HOU","SF",1720560,77,2,1419,203,429,0.473,60,187,0.321,143,242,0.591,0.543,38,68,0.559,94,190,284,76,38,21,41,83,504
"Trevor Ariza",2017,"HOU","SF",7806971,80,80,2773,326,798,0.409,191,555,0.344,135,243,0.556,0.528,93,126,0.738,54,405,459,175,147,20,74,133,936
"Troy Williams",2017,"HOU","SF",150000,6,3,139,22,44,0.5,8,21,0.381,14,23,0.609,0.591,6,7,0.857,9,15,24,6,3,1,6,18,58
"Alan Anderson",2017,"LAC","SF",1315448,30,0,308,30,80,0.375,14,44,0.318,16,36,0.444,0.463,12,16,0.75,3,21,24,11,3,0,7,35,86
"Austin Rivers",2017,"LAC","SG",1.1e+07,74,29,2054,323,731,0.442,111,299,0.371,212,432,0.491,0.518,132,191,0.691,20,141,161,204,48,10,115,187,889
"Blake Griffin",2017,"LAC","PF",20140838,61,61,2076,479,971,0.493,38,113,0.336,441,858,0.514,0.513,320,421,0.76,111,385,496,300,58,23,142,157,1316
"Brandon Bass",2017,"LAC","PF",1551659,52,0,577,107,186,0.575,1,3,0.333,106,183,0.579,0.578,77,88,0.875,43,86,129,21,14,11,29,45,292
"Chris Paul",2017,"LAC","PG",22868828,61,61,1921,374,785,0.476,124,302,0.411,250,483,0.518,0.555,232,260,0.892,41,263,304,563,118,8,147,146,1104
"DeAndre Jordan",2017,"LAC","C",21165675,81,81,2570,412,577,0.714,0,2,0,412,575,0.717,0.714,205,425,0.482,297,817,1114,96,52,135,116,212,1029
"J.J. Redick",2017,"LAC","SG",7377500,78,78,2198,396,890,0.445,201,468,0.429,195,422,0.462,0.558,180,202,0.891,11,160,171,110,55,13,98,125,1173
"Jamal Crawford",2017,"LAC","SG",13253012,82,1,2157,359,869,0.413,116,322,0.36,243,547,0.444,0.48,174,203,0.857,17,112,129,213,59,14,134,115,1008
"Luc Mbah a Moute",2017,"LAC","SF",2203000,80,76,1787,191,378,0.505,43,110,0.391,148,268,0.552,0.562,59,87,0.678,47,127,174,39,81,35,47,122,484
"Marreese Speights",2017,"LAC","C",1403611,82,2,1286,244,548,0.445,103,277,0.372,141,271,0.52,0.539,120,137,0.876,88,285,373,66,23,41,69,229,711
"Paul Pierce",2017,"LAC","SF",3500000,25,7,277,28,70,0.4,15,43,0.349,13,27,0.481,0.507,10,13,0.769,1,47,48,10,4,5,16,40,81
"Raymond Felton",2017,"LAC","PG",1551659,80,11,1700,221,514,0.43,46,144,0.319,175,370,0.473,0.475,50,64,0.781,33,184,217,191,67,22,83,125,538
"Wesley Johnson",2017,"LAC","SF",5628000,68,3,810,73,200,0.365,29,118,0.246,44,82,0.537,0.438,11,17,0.647,26,155,181,23,29,30,18,83,186
"Alec Burks",2017,"UTA","SG",10154495,42,0,653,99,248,0.399,25,76,0.329,74,172,0.43,0.45,60,78,0.769,17,103,120,30,18,5,35,50,283
"Boris Diaw",2017,"UTA","PF",7e+06,73,33,1283,146,327,0.446,20,81,0.247,126,246,0.512,0.477,26,35,0.743,46,112,158,170,18,9,87,83,338
"Dante Exum",2017,"UTA","PG",3940320,66,26,1228,155,364,0.426,44,149,0.295,111,215,0.516,0.486,58,73,0.795,30,102,132,112,21,12,80,146,412
"Derrick Favors",2017,"UTA","PF",11050000,50,39,1186,203,417,0.487,3,10,0.3,200,407,0.491,0.49,67,109,0.615,92,213,305,56,45,40,60,103,476
"George Hill",2017,"UTA","PG",8e+06,49,49,1544,289,606,0.477,94,233,0.403,195,373,0.523,0.554,157,196,0.801,23,144,167,203,50,11,85,114,829
"Gordon Hayward",2017,"UTA","SF",16073140,73,73,2516,545,1156,0.471,149,374,0.398,396,782,0.506,0.536,362,429,0.844,49,344,393,252,73,20,140,117,1601
"Jeff Withey",2017,"UTA","C",1015696,51,1,432,55,103,0.534,0,1,0,55,102,0.539,0.534,36,48,0.75,52,69,121,7,16,32,14,52,146
"Joe Ingles",2017,"UTA","SF",2250000,82,26,1972,204,451,0.452,123,279,0.441,81,172,0.471,0.589,50,68,0.735,23,237,260,224,96,8,107,163,581
"Joe Johnson",2017,"UTA","SF",1.1e+07,78,14,1843,273,626,0.436,106,258,0.411,167,368,0.454,0.521,63,77,0.818,33,209,242,144,35,18,69,93,715
"Joel Bolomboy",2017,"UTA","PF",6e+05,12,0,53,9,16,0.563,1,4,0.25,8,12,0.667,0.594,3,6,0.5,4,13,17,2,1,2,2,1,22
"Raul Neto",2017,"UTA","PG",937800,40,0,346,41,91,0.451,10,31,0.323,31,60,0.517,0.505,8,9,0.889,4,26,30,34,21,5,15,48,100
"Rodney Hood",2017,"UTA","SG",1406520,59,55,1593,272,666,0.408,114,306,0.373,158,360,0.439,0.494,90,115,0.783,16,186,202,96,39,11,65,132,748
"Rudy Gobert",2017,"UTA","C",2121288,81,81,2744,413,623,0.663,0,1,0,413,622,0.664,0.663,311,476,0.653,314,721,1035,97,49,214,148,246,1137
"Shelvin Mack",2017,"UTA","PG",2433334,55,9,1205,170,381,0.446,37,120,0.308,133,261,0.51,0.495,53,77,0.688,20,108,128,154,42,3,90,100,430
"Trey Lyles",2017,"UTA","PF",2340600,71,4,1158,159,439,0.362,65,204,0.319,94,235,0.4,0.436,57,79,0.722,48,187,235,70,26,20,64,97,440
"Alex Abrines",2017,"OKC","SG",5994764,68,6,1055,134,341,0.393,94,247,0.381,40,94,0.426,0.531,44,49,0.898,18,68,86,40,37,8,33,114,406
"Andre Roberson",2017,"OKC","SF",2183072,79,79,2376,215,463,0.464,45,184,0.245,170,279,0.609,0.513,47,111,0.423,98,304,402,79,94,79,51,204,522
"Domantas Sabonis",2017,"OKC","PF",2440200,81,66,1632,192,481,0.399,51,159,0.321,141,322,0.438,0.452,44,67,0.657,45,242,287,82,39,32,83,200,479
"Doug McDermott",2017,"OKC","SF",2483040,22,1,430,56,124,0.452,21,58,0.362,35,66,0.53,0.536,12,17,0.706,6,43,49,13,2,1,6,22,145
"Enes Kanter",2017,"OKC","C",17145838,72,0,1533,402,737,0.545,5,38,0.132,397,699,0.568,0.549,224,285,0.786,195,287,482,67,32,38,123,154,1033
"Jerami Grant",2017,"OKC","SF",980431,78,4,1490,146,311,0.469,43,114,0.377,103,197,0.523,0.539,86,139,0.619,38,161,199,46,33,75,41,144,421
"Josh Huestis",2017,"OKC","PF",1191480,2,0,31,6,11,0.545,2,4,0.5,4,7,0.571,0.636,0,1,0,4,5,9,3,0,3,0,0,14
"Kyle Singler",2017,"OKC","SF",4837500,32,2,385,34,83,0.41,7,37,0.189,27,46,0.587,0.452,13,17,0.765,8,40,48,9,7,5,11,29,88
"Nick Collison",2017,"OKC","PF",3750000,20,0,128,14,23,0.609,0,1,0,14,22,0.636,0.609,5,8,0.625,9,21,30,12,2,2,4,17,33
"Norris Cole",2017,"OKC","PG",247991,13,0,125,16,52,0.308,3,13,0.231,13,39,0.333,0.337,8,10,0.8,0,11,11,14,8,0,7,18,43
"Russell Westbrook",2017,"OKC","PG",26540100,81,81,2802,824,1941,0.425,200,583,0.343,624,1358,0.459,0.476,710,840,0.845,137,727,864,840,133,31,438,190,2558
"Semaj Christon",2017,"OKC","PG",543471,64,1,973,77,223,0.345,12,63,0.19,65,160,0.406,0.372,17,31,0.548,19,69,88,130,28,6,43,79,183
"Steven Adams",2017,"OKC","C",3140517,80,80,2389,374,655,0.571,0,1,0,374,654,0.572,0.571,157,257,0.611,282,333,615,86,88,78,146,195,905
"Taj Gibson",2017,"OKC","PF",8950000,23,16,487,89,179,0.497,1,1,1,88,178,0.494,0.5,28,39,0.718,38,65,103,13,14,15,28,40,207
"Victor Oladipo",2017,"OKC","SG",6552960,67,67,2222,412,932,0.442,127,352,0.361,285,580,0.491,0.51,116,154,0.753,39,252,291,176,78,21,119,155,1067
"Andrew Harrison",2017,"MEM","PG",945000,72,18,1474,117,360,0.325,43,156,0.276,74,204,0.363,0.385,148,194,0.763,23,113,136,198,54,20,85,194,425
"Brandan Wright",2017,"MEM","PF",5700000,28,5,447,83,135,0.615,0,1,0,83,134,0.619,0.615,23,35,0.657,31,47,78,15,11,20,10,42,189
"Chandler Parsons",2017,"MEM","SF",22116750,34,34,675,75,222,0.338,25,93,0.269,50,129,0.388,0.394,35,43,0.814,6,78,84,55,20,5,24,52,210
"James Ennis",2017,"MEM","SF",2898000,64,28,1501,146,321,0.455,51,137,0.372,95,184,0.516,0.534,86,110,0.782,69,190,259,64,46,19,59,165,429
"JaMychal Green",2017,"MEM","PF",980431,77,75,2101,250,500,0.5,55,145,0.379,195,355,0.549,0.555,134,167,0.802,167,377,544,84,46,34,94,248,689
"Jarell Martin",2017,"MEM","PF",1286160,42,3,558,58,151,0.384,9,25,0.36,49,126,0.389,0.414,40,50,0.8,42,120,162,8,17,9,28,91,165
"Marc Gasol",2017,"MEM","C",21165675,74,74,2531,532,1160,0.459,104,268,0.388,428,892,0.48,0.503,278,332,0.837,60,402,462,338,67,99,166,171,1446
"Mike Conley",2017,"MEM","PG",26540100,69,68,2292,464,1009,0.46,171,419,0.408,293,590,0.497,0.545,316,368,0.859,31,211,242,433,92,19,156,126,1415
"Tony Allen",2017,"MEM","SG",5505618,71,66,1914,274,595,0.461,15,54,0.278,259,541,0.479,0.473,80,130,0.615,166,225,391,98,115,29,100,178,643
"Troy Daniels",2017,"MEM","SG",3332940,67,3,1183,185,495,0.374,138,355,0.389,47,140,0.336,0.513,43,54,0.796,21,79,100,46,21,4,45,90,551
"Vince Carter",2017,"MEM","SF",4264057,73,15,1799,193,490,0.394,112,296,0.378,81,194,0.418,0.508,88,115,0.765,36,191,227,133,60,36,50,163,586
"Wade Baldwin",2017,"MEM","PG",1793760,33,1,405,36,115,0.313,3,22,0.136,33,93,0.355,0.326,31,37,0.838,11,35,46,61,18,7,40,40,106
"Wayne Selden",2017,"MEM","SG",83119,11,2,189,20,50,0.4,3,21,0.143,17,29,0.586,0.43,12,18,0.667,1,10,11,12,4,1,9,12,55
"Zach Randolph",2017,"MEM","PF",10361445,73,5,1786,433,964,0.449,21,94,0.223,412,870,0.474,0.46,141,193,0.731,182,416,598,122,38,10,99,136,1028
"Al-Farouq Aminu",2017,"POR","SF",7680965,61,25,1773,183,466,0.393,70,212,0.33,113,254,0.445,0.468,96,136,0.706,77,374,451,99,60,44,94,102,532
"Allen Crabbe",2017,"POR","SG",18500000,79,7,2254,303,647,0.468,134,302,0.444,169,345,0.49,0.572,105,124,0.847,19,206,225,93,54,20,62,171,845
"C.J. McCollum",2017,"POR","SG",3219579,80,80,2796,692,1441,0.48,185,440,0.42,507,1001,0.506,0.544,268,294,0.912,60,231,291,285,72,42,172,202,1837
"Damian Lillard",2017,"POR","PG",24328425,75,75,2694,661,1488,0.444,214,578,0.37,447,910,0.491,0.516,488,545,0.895,46,322,368,439,68,20,197,152,2024
"Evan Turner",2017,"POR","SF",16393443,65,12,1658,235,552,0.426,31,118,0.263,204,434,0.47,0.454,85,103,0.825,36,211,247,205,53,24,100,121,586
"Jake Layman",2017,"POR","SF",6e+05,35,1,249,26,89,0.292,13,51,0.255,13,38,0.342,0.365,13,17,0.765,6,18,24,11,9,3,11,22,78
"Jusuf Nurkic",2017,"POR","C",1921320,20,19,584,120,236,0.508,0,1,0,120,235,0.511,0.508,64,97,0.66,65,142,207,63,25,38,62,73,304
"Maurice Harkless",2017,"POR","SF",8988764,77,69,2223,314,624,0.503,68,194,0.351,246,430,0.572,0.558,77,124,0.621,125,216,341,89,85,70,85,214,773
"Meyers Leonard",2017,"POR","PF",9213484,74,12,1222,146,378,0.386,74,213,0.347,72,165,0.436,0.484,35,40,0.875,27,209,236,71,13,28,35,172,401
"Noah Vonleh",2017,"POR","PF",2751360,74,41,1265,130,270,0.481,7,20,0.35,123,250,0.492,0.494,60,94,0.638,131,256,387,31,30,27,64,154,327
"Pat Connaughton",2017,"POR","SG",874636,39,1,316,37,72,0.514,17,33,0.515,20,39,0.513,0.632,7,9,0.778,10,42,52,28,6,2,17,23,98
"Shabazz Napier",2017,"POR","PG",1350120,53,2,512,73,183,0.399,34,92,0.37,39,91,0.429,0.492,38,49,0.776,8,53,61,67,32,2,41,38,218
"Tim Quarterman",2017,"POR","SG",543471,16,0,80,13,29,0.448,5,13,0.385,8,16,0.5,0.534,0,3,0,4,10,14,11,2,3,11,6,31
"Danilo Gallinari",2017,"DEN","SF",15050000,63,63,2134,335,750,0.447,126,325,0.388,209,425,0.492,0.531,349,387,0.902,39,287,326,136,41,15,81,93,1145
"Darrell Arthur",2017,"DEN","PF",8070175,41,7,639,95,215,0.442,53,117,0.453,42,98,0.429,0.565,19,22,0.864,25,87,112,42,19,21,36,76,262
"Emmanuel Mudiay",2017,"DEN","PG",3241800,55,41,1406,208,551,0.377,56,177,0.316,152,374,0.406,0.428,131,167,0.784,30,150,180,217,41,13,123,95,603
"Gary Harris",2017,"DEN","SG",1655880,57,56,1782,320,636,0.503,107,255,0.42,213,381,0.559,0.587,104,134,0.776,48,130,178,164,71,8,76,92,851
"Jamal Murray",2017,"DEN","SG",3210840,82,10,1764,295,729,0.405,115,344,0.334,180,385,0.468,0.484,106,120,0.883,41,173,214,170,53,24,113,124,811
"Jameer Nelson",2017,"DEN","PG",4540525,75,39,2045,268,604,0.444,106,273,0.388,162,331,0.489,0.531,45,63,0.714,28,164,192,385,53,8,129,197,687
"Juan Hernangomez",2017,"DEN","PF",1987440,62,9,842,101,223,0.453,46,112,0.411,55,111,0.495,0.556,57,76,0.75,43,144,187,29,29,12,31,62,305
"Kenneth Faried",2017,"DEN","PF",12078652,61,34,1296,228,415,0.549,0,6,0,228,409,0.557,0.549,131,189,0.693,180,279,459,55,43,40,58,124,587
"Malik Beasley",2017,"DEN","SG",1627320,22,1,165,33,73,0.452,9,28,0.321,24,45,0.533,0.514,8,10,0.8,5,12,17,11,7,0,8,10,83
"Mason Plumlee",2017,"DEN","C",2328530,27,10,632,99,181,0.547,0,1,0,99,180,0.55,0.547,47,76,0.618,50,123,173,70,19,29,46,77,245
"Mike Miller",2017,"DEN","SF",3500000,20,0,151,9,23,0.391,8,20,0.4,1,3,0.333,0.565,2,2,1,3,36,39,22,2,0,13,9,28
"Nikola Jokic",2017,"DEN","C",1358500,73,59,2038,494,856,0.577,45,139,0.324,449,717,0.626,0.603,188,228,0.825,212,503,715,358,60,55,171,214,1221
"Will Barton",2017,"DEN","SG",3533333,60,19,1705,295,667,0.442,87,235,0.37,208,432,0.481,0.507,143,190,0.753,58,201,259,206,48,28,97,110,820
"Wilson Chandler",2017,"DEN","SF",11200000,71,33,2197,433,940,0.461,110,326,0.337,323,614,0.526,0.519,141,194,0.727,104,356,460,143,52,30,114,172,1117
"Alexis Ajinca",2017,"NOP","C",4600000,39,15,584,89,178,0.5,0,4,0,89,174,0.511,0.5,29,40,0.725,46,131,177,12,20,22,31,77,207
"Anthony Davis",2017,"NOP","C",22116750,75,75,2708,770,1527,0.504,40,134,0.299,730,1393,0.524,0.517,519,647,0.802,174,712,886,157,94,167,181,168,2099
"Dante Cunningham",2017,"NOP","SF",2978250,66,35,1649,174,359,0.485,71,181,0.392,103,178,0.579,0.584,16,27,0.593,56,221,277,36,39,28,28,100,435
"DeMarcus Cousins",2017,"NOP","C",16957900,17,17,574,142,314,0.452,36,96,0.375,106,218,0.486,0.51,94,121,0.777,38,174,212,66,25,19,62,75,414
"Donatas Motiejunas",2017,"NOP","PF",576724,34,0,479,57,138,0.413,11,47,0.234,46,91,0.505,0.453,25,49,0.51,26,75,101,34,18,11,31,55,150
"E'Twaun Moore",2017,"NOP","SG",8081363,73,22,1820,283,619,0.457,77,208,0.37,206,411,0.501,0.519,57,74,0.77,33,119,152,164,50,32,62,131,700
"Jordan Crawford",2017,"NOP","SG",173094,19,0,442,105,218,0.482,37,95,0.389,68,123,0.553,0.567,20,26,0.769,4,30,34,57,11,2,25,30,267
"Jrue Holiday",2017,"NOP","PG",11286518,67,61,2190,405,894,0.453,100,281,0.356,305,613,0.498,0.509,119,168,0.708,46,218,264,488,100,43,194,133,1029
"Quinn Cook",2017,"NOP","PG",63938,9,0,111,22,41,0.537,6,12,0.5,16,29,0.552,0.61,2,3,0.667,1,3,4,14,3,0,5,7,52
"Solomon Hill",2017,"NOP","SF",11241218,80,71,2374,183,477,0.384,94,270,0.348,89,207,0.43,0.482,103,128,0.805,51,256,307,141,71,32,82,182,563
"Tim Frazier",2017,"NOP","PG",2090000,65,35,1525,163,404,0.403,40,128,0.313,123,276,0.446,0.453,98,129,0.76,34,139,173,335,56,6,101,133,464
"A.J. Hammons",2017,"DAL","C",650000,22,0,163,17,42,0.405,5,10,0.5,12,32,0.375,0.464,9,20,0.45,8,28,36,4,1,13,10,21,48
"DeAndre Liggins",2017,"DAL","SG",1015696,1,0,25,3,6,0.5,0,1,0,3,5,0.6,0.5,2,3,0.667,3,4,7,0,2,0,0,3,8
"Devin Harris",2017,"DAL","PG",4228000,65,0,1087,136,341,0.399,58,177,0.328,78,164,0.476,0.484,107,129,0.829,11,116,127,136,43,7,57,101,437
"Dirk Nowitzki",2017,"DAL","PF",2.5e+07,54,54,1424,296,678,0.437,79,209,0.378,217,469,0.463,0.495,98,112,0.875,23,330,353,82,30,38,51,113,769
"Dorian Finney-Smith",2017,"DAL","PF",543471,81,35,1642,124,333,0.372,56,191,0.293,68,142,0.479,0.456,46,61,0.754,55,166,221,67,52,25,45,125,350
"Dwight Powell",2017,"DAL","C",8375000,77,3,1333,194,377,0.515,21,74,0.284,173,303,0.571,0.542,107,141,0.759,94,213,307,49,61,39,34,135,516
"Harrison Barnes",2017,"DAL","PF",22116750,79,79,2803,599,1280,0.468,78,222,0.351,521,1058,0.492,0.498,242,281,0.861,94,303,397,117,66,15,102,128,1518
"J.J. Barea",2017,"DAL","PG",4096950,35,6,771,142,343,0.414,53,148,0.358,89,195,0.456,0.491,44,51,0.863,9,75,84,193,14,1,63,30,381
"Jarrod Uthoff",2017,"DAL","PF",63938,9,0,115,16,38,0.421,3,9,0.333,13,29,0.448,0.461,5,7,0.714,8,14,22,9,2,4,3,8,40
"Nicolas Brussino",2017,"DAL","SF",543471,54,2,521,52,141,0.369,29,95,0.305,23,46,0.5,0.472,17,22,0.773,26,69,95,47,17,8,26,43,150
"Salah Mejri",2017,"DAL","C",874636,73,11,905,88,137,0.642,1,3,0.333,87,134,0.649,0.646,36,61,0.59,97,211,308,14,32,61,40,152,213
"Seth Curry",2017,"DAL","PG",2898000,70,42,2029,338,703,0.481,137,322,0.425,201,381,0.528,0.578,85,100,0.85,25,153,178,188,79,7,92,126,898
"Wesley Matthews",2017,"DAL","SG",17100000,73,73,2495,333,847,0.393,174,479,0.363,159,368,0.432,0.496,146,179,0.816,18,241,259,210,77,16,102,161,986
"Yogi Ferrell",2017,"DAL","PG",207798,36,29,1046,142,345,0.412,60,149,0.403,82,196,0.418,0.499,64,73,0.877,16,83,99,155,40,7,56,79,408
"Anthony Tolliver",2017,"SAC","PF",8e+06,65,9,1477,155,351,0.442,90,230,0.391,65,121,0.537,0.57,61,82,0.744,51,188,239,77,33,20,56,109,461
"Arron Afflalo",2017,"SAC","SG",12500000,61,45,1580,185,420,0.44,62,151,0.411,123,269,0.457,0.514,83,93,0.892,9,116,125,78,21,7,42,104,515
"Ben McLemore",2017,"SAC","SG",4008882,61,26,1176,180,419,0.43,65,170,0.382,115,249,0.462,0.507,70,93,0.753,19,111,130,51,29,6,62,108,495
"Buddy Hield",2017,"SAC","SG",3517200,25,18,727,142,296,0.48,59,138,0.428,83,158,0.525,0.579,35,43,0.814,16,87,103,44,20,2,53,34,378
"Darren Collison",2017,"SAC","PG",5229454,68,64,2063,340,714,0.476,73,175,0.417,267,539,0.495,0.527,147,171,0.86,23,130,153,312,67,9,114,119,900
"Garrett Temple",2017,"SAC","SG",8e+06,65,21,1728,183,432,0.424,82,220,0.373,101,212,0.476,0.519,58,74,0.784,32,151,183,169,84,28,78,141,506
"Georgios Papagiannis",2017,"SAC","C",2202240,22,0,355,56,102,0.549,0,2,0,56,100,0.56,0.549,12,14,0.857,24,62,86,20,3,17,24,44,124
"Kosta Koufos",2017,"SAC","C",8046500,71,62,1419,216,392,0.551,0,1,0,216,391,0.552,0.551,38,62,0.613,118,285,403,47,36,48,61,172,470
"Langston Galloway",2017,"SAC","PG",5200000,19,2,375,42,104,0.404,19,40,0.475,23,64,0.359,0.495,11,12,0.917,7,28,35,28,6,1,18,20,114
"Malachi Richardson",2017,"SAC","SG",1439880,22,0,198,28,68,0.412,8,28,0.286,20,40,0.5,0.471,15,19,0.789,3,20,23,11,5,1,8,23,79
"Rudy Gay",2017,"SAC","SF",13333333,30,30,1013,201,442,0.455,42,113,0.372,159,329,0.483,0.502,118,138,0.855,35,155,190,82,44,26,74,79,562
"Skal Labissiere",2017,"SAC","PF",1188840,33,12,612,117,218,0.537,3,8,0.375,114,210,0.543,0.544,52,74,0.703,51,111,162,27,16,13,37,64,289
"Ty Lawson",2017,"SAC","PG",1315448,69,24,1732,237,522,0.454,34,118,0.288,203,404,0.502,0.487,173,217,0.797,44,135,179,335,74,6,129,119,681
"Tyreke Evans",2017,"SAC","SF",10661286,14,6,314,59,143,0.413,21,48,0.438,38,95,0.4,0.486,24,34,0.706,7,44,51,33,12,5,22,19,163
"Willie Cauley-Stein",2017,"SAC","C",3551160,75,21,1421,255,481,0.53,0,2,0,255,479,0.532,0.53,101,151,0.669,85,255,340,80,53,45,69,147,611
"Adreian Payne",2017,"MIN","PF",2022240,18,0,135,23,54,0.426,3,15,0.2,20,39,0.513,0.454,14,19,0.737,9,24,33,7,8,7,8,32,63
"Andrew Wiggins",2017,"MIN","SF",6006600,82,82,3048,709,1570,0.452,103,289,0.356,606,1281,0.473,0.484,412,542,0.76,103,226,329,189,82,30,187,183,1933
"Brandon Rush",2017,"MIN","SG",3500000,47,33,1030,70,187,0.374,44,114,0.386,26,73,0.356,0.492,13,18,0.722,16,83,99,45,22,23,28,42,197
"Gorgui Dieng",2017,"MIN","PF",2348783,82,82,2653,332,661,0.502,16,43,0.372,316,618,0.511,0.514,136,167,0.814,188,459,647,158,88,95,107,254,816
"Karl-Anthony Towns",2017,"MIN","C",5960160,82,82,3030,802,1479,0.542,101,275,0.367,701,1204,0.582,0.576,356,428,0.832,296,711,1007,220,57,103,212,241,2061
"Kris Dunn",2017,"MIN","PG",3872520,78,7,1333,118,313,0.377,21,73,0.288,97,240,0.404,0.411,36,59,0.61,24,142,166,188,78,36,89,178,293
"Nemanja Bjelica",2017,"MIN","PF",3800000,65,1,1190,151,356,0.424,56,177,0.316,95,179,0.531,0.503,45,61,0.738,57,187,244,79,40,20,59,154,403
"Omri Casspi",2017,"MIN","SF",138414,13,0,222,19,39,0.487,2,10,0.2,17,29,0.586,0.513,5,8,0.625,6,14,20,11,13,2,10,24,45
"Ricky Rubio",2017,"MIN","PG",13550000,75,75,2469,261,650,0.402,60,196,0.306,201,454,0.443,0.448,254,285,0.891,68,237,305,682,128,10,195,202,836
"Shabazz Muhammad",2017,"MIN","SF",3046299,78,1,1516,288,598,0.482,49,146,0.336,239,452,0.529,0.523,147,190,0.774,84,136,220,35,22,6,56,86,772
"Tyus Jones",2017,"MIN","PG",1339680,60,0,774,75,181,0.414,26,73,0.356,49,108,0.454,0.486,33,43,0.767,10,57,67,156,47,5,38,50,209
"Zach LaVine",2017,"MIN","SG",2240880,47,47,1749,326,710,0.459,120,310,0.387,206,400,0.515,0.544,117,140,0.836,18,141,159,139,41,10,85,104,889
"Brandon Ingram",2017,"LAL","SF",5281680,79,40,2279,276,686,0.402,55,187,0.294,221,499,0.443,0.442,133,214,0.621,60,257,317,166,50,36,116,158,740
"Corey Brewer",2017,"LAL","SF",7600000,24,3,358,53,121,0.438,5,24,0.208,48,97,0.495,0.459,18,24,0.75,11,41,52,36,24,8,19,29,129
"D'Angelo Russell",2017,"LAL","PG",5332800,63,60,1811,351,867,0.405,135,384,0.352,216,483,0.447,0.483,147,188,0.782,31,191,222,303,87,16,176,130,984
"David Nwaba",2017,"LAL","SG",73528,20,2,397,47,81,0.58,1,5,0.2,46,76,0.605,0.586,25,39,0.641,16,46,62,14,13,7,11,36,120
"Ivica Zubac",2017,"LAL","C",1034956,38,11,609,126,238,0.529,0,3,0,126,235,0.536,0.529,32,49,0.653,41,118,159,30,14,33,30,66,284
"Jordan Clarkson",2017,"LAL","SG",12500000,82,19,2397,477,1071,0.445,117,356,0.329,360,715,0.503,0.5,134,168,0.798,49,197,246,213,88,8,164,150,1205
"Julius Randle",2017,"LAL","PF",3267120,74,73,2132,377,773,0.488,17,63,0.27,360,710,0.507,0.499,204,282,0.723,151,485,636,264,49,37,173,248,975
"Larry Nance Jr.",2017,"LAL","PF",1207680,63,7,1442,190,361,0.526,10,36,0.278,180,325,0.554,0.54,59,80,0.738,120,249,369,96,82,40,56,149,449
"Luol Deng",2017,"LAL","SF",1.8e+07,56,49,1486,164,424,0.387,51,165,0.309,113,259,0.436,0.447,46,63,0.73,63,232,295,74,48,20,43,61,425
"Metta World Peace",2017,"LAL","SF",1551659,25,2,160,19,68,0.279,9,38,0.237,10,30,0.333,0.346,10,16,0.625,5,15,20,11,9,2,7,18,57
"Nick Young",2017,"LAL","SG",5443918,60,60,1556,272,633,0.43,170,421,0.404,102,212,0.481,0.564,77,90,0.856,25,112,137,58,37,14,36,137,791
"Tarik Black",2017,"LAL","C",6191000,67,16,1091,150,294,0.51,1,2,0.5,149,292,0.51,0.512,82,109,0.752,143,199,342,39,30,44,58,173,383
"Thomas Robinson",2017,"LAL","PF",1050961,48,1,560,105,196,0.536,0,1,0,105,195,0.538,0.536,31,66,0.47,84,139,223,31,26,9,46,76,241
"Timofey Mozgov",2017,"LAL","C",1.6e+07,54,52,1104,169,328,0.515,0,1,0,169,327,0.517,0.515,63,78,0.808,104,160,264,43,16,31,72,133,401
"Tyler Ennis",2017,"LAL","PG",1733880,22,2,392,65,144,0.451,21,54,0.389,44,90,0.489,0.524,19,22,0.864,6,21,27,52,20,2,21,29,170
"Alan Williams",2017,"PHO","C",874636,47,0,708,138,267,0.517,0,1,0,138,266,0.519,0.517,70,112,0.625,94,198,292,23,27,32,37,125,346
"Alex Len",2017,"PHO","C",4823621,77,34,1560,230,463,0.497,3,12,0.25,227,451,0.503,0.5,150,208,0.721,156,354,510,44,37,98,102,242,613
"Brandon Knight",2017,"PHO","SG",12606250,54,5,1140,209,525,0.398,45,139,0.324,164,386,0.425,0.441,132,154,0.857,25,93,118,130,27,5,89,87,595
"Derrick Jones",2017,"PHO","SF",543471,32,8,545,68,121,0.562,3,11,0.273,65,110,0.591,0.574,29,41,0.707,39,40,79,12,14,13,13,63,168
"Devin Booker",2017,"PHO","SG",2223600,78,78,2730,606,1431,0.423,147,405,0.363,459,1026,0.447,0.475,367,441,0.832,46,203,249,268,72,21,241,242,1726
"Dragan Bender",2017,"PHO","PF",4276320,43,0,574,57,161,0.354,28,101,0.277,29,60,0.483,0.441,4,11,0.364,23,80,103,23,10,22,32,74,146
"Elijah Millsap",2017,"PHO","SG",23069,2,0,23,1,7,0.143,0,2,0,1,5,0.2,0.143,1,2,0.5,3,3,6,1,0,0,2,2,3
"Eric Bledsoe",2017,"PHO","PG",1.4e+07,66,66,2176,449,1034,0.434,104,310,0.335,345,724,0.477,0.485,388,458,0.847,52,268,320,418,92,31,223,164,1390
"Jared Dudley",2017,"PHO","PF",10470000,64,7,1362,157,346,0.454,77,203,0.379,80,143,0.559,0.565,43,65,0.662,31,194,225,121,42,16,72,154,434
"Leandro Barbosa",2017,"PHO","SG",4e+06,67,0,963,172,392,0.439,35,98,0.357,137,294,0.466,0.483,40,45,0.889,15,89,104,81,31,8,48,82,419
"Marquese Chriss",2017,"PHO","PF",2941440,82,75,1743,284,632,0.449,72,224,0.321,212,408,0.52,0.506,113,181,0.624,96,252,348,60,67,70,108,263,753
"Ronnie Price",2017,"PHO","PG",282595,14,0,134,4,24,0.167,3,17,0.176,1,7,0.143,0.229,3,4,0.75,3,8,11,18,11,1,3,14,14
"T.J. Warren",2017,"PHO","SF",2128920,66,59,2048,403,814,0.495,26,98,0.265,377,716,0.527,0.511,119,154,0.773,125,214,339,75,76,39,57,175,951
"Tyler Ulis",2017,"PHO","PG",918369,61,15,1123,184,437,0.421,21,79,0.266,163,358,0.455,0.445,55,71,0.775,20,75,95,226,48,5,77,73,444
